..................................
..................................
..................................
..................................
..................................
...########.......................
...#......................########
...#......................#.......
...#............#.........#.......
...########.....#.........#.......
...#......................#.......
...#.....#................#.......
...#............#.........#.......
...#............#.........#.......
...########...............########
..................................
..............#########...........
..................................
..................................
..................................
..................................
..................................
..................................
..................................
..................................
..................................
..................................
..................................
..................................
..................................
..................................
..................................
..................................
..................................
..................................